11111111111111111111111111111111111111
10E100000000100000E0000011100000111111
10P00111110011111000000000000000111111
100011E0000000000000C00000000010111111
11111111111111111111111111111111111111