11111111111111111111111111111111
1001C000000C1C000000000C11100001
1000011111001111100000C0000000C1
1P0011E00000000000000C0000000011
11111111111111111111111111111111