11111111111111111111111111111111
10010000000C1C000000000C11100001
100001111100111110000000000000C1
1P0011E00000000000000C0000000011
11111111111111111111111111111111