111111111111111111111111111111111
10E100000000100000E00000111000001
10P001111100111110000000000000001
100011E0000000000000C000000000101
111111111111111111111111111111111