111111111111111111111111111111111
10E1C000000C1C0000E0000C111000001
100P011111001111100000C0000000C01
100011E00000000000000C00000000101
111111111111111111111111111111111