11111111111111111111111111111111
10E1C000000C1C0000E0000C11100001
100P011111001111100000C0000000C1
100011E00000000000000C0000000011
11111111111111111111111111111111
