1111111111111111111111111111111111
10000C0000000000000000E00000000001
1010010100100000101001000000010101
1010010010101010001001000000010101
100P00000000000000E000000000000001
1111111111111111111111111111111111